1111111111
1P00000011
1110111111
1C001100E1
1111111111