1111111111111111111
1P00000011111000001
100C111011110C00001
10000000C0000000001
1110011110001110011
100C0010000000C0001
1000000111100000001
1C000C0000110000C01
10000000000E0000001
1111111111111111111