1111111111111111111
11P00000000C0000111
1101110C11111111111
1101110111111111111
11011000C1111111111
11010C0111111111111
10000000000C0000C01
111111111111100C111
1E0000000C000C00001
1111111111111111111